##############################
#@#                          #
# ##                         #
#                            #
####                         #
#                            #
#                            #
#                            #
#                            #
#                            #
#                            #
#                            #
#                            #
#             #              #
#            ###             #
#             #              #
#                            #
#                            #
#                            #
#                            #
#                            #
#                            #
#                            #
#                            #
#                            #
#                            #
#                       # ####
#                       #   X#
##############################